Symbol,StartDt,Duration,TotalUpRate,MeanUpRate,UpDuration,MeanDownRate,DownDuration,Up/Down_Rate,BullIndex
AAOI,20170110,141,3.408007197,0.042655475,79,-0.027278396,62,1.274193548,434
ESPR,20170124,132,3.132178669,0.049494578,72,-0.0294332,60,1.2,375
FIZZ,20170119,135,1.359782609,0.016997945,92,-0.015473115,43,2.139534884,290
WTW,20170104,145,1.985559567,0.028482464,85,-0.020192054,60,1.416666667,281
PBYI,20170509,59,1.960344828,0.050629702,34,-0.018547277,25,1.36,261
BZUN,20170105,144,1.79380531,0.030475623,84,-0.023702207,60,1.4,251
XENT,20170109,142,1.493670886,0.021974307,89,-0.018406029,53,1.679245283,250
HIIQ,20170328,88,1.06993007,0.025639002,61,-0.028658277,27,2.259259259,241
GNCMA,20170309,101,1.364201016,0.021976964,64,-0.010650678,37,1.72972973,235
SGMS,20170104,145,1.571428571,0.02288964,86,-0.016030959,59,1.457627119,229
STMP,20170413,76,0.996116505,0.024129604,53,-0.022261015,23,2.304347826,228
MOMO,20170104,145,1.43442623,0.025046431,89,-0.022385208,56,1.589285714,227
PETS,20170310,100,1.483904465,0.02422936,60,-0.012057843,40,1.5,222
EXAS,20170104,145,1.893363162,0.031988424,77,-0.018852144,68,1.132352941,214
PTLA,20170104,145,1.684487292,0.026140214,81,-0.01558166,64,1.265625,213
SHOP,20170104,145,1.269033162,0.020706317,90,-0.018063735,55,1.636363636,207
TRTN,20170104,145,1.124415888,0.021325049,93,-0.022463509,52,1.788461538,201
SEDG,20170207,122,1.243902439,0.021508002,75,-0.015902536,47,1.595744681,198
KITE,20170124,132,1.407536484,0.026163177,76,-0.018246242,56,1.357142857,191
W,20170104,145,1.198123934,0.02019109,89,-0.016996191,56,1.589285714,190
TREE,20170104,145,1.338078292,0.020321083,84,-0.013203673,61,1.37704918,184
TAL,20170104,145,1.196356557,0.017859151,88,-0.013142246,57,1.543859649,184
ALNY,20170131,127,1.209869848,0.026389945,75,-0.021393971,52,1.442307692,174
RH,20170208,121,1.352472089,0.034009907,68,-0.024850976,53,1.283018868,173
BGNE,20170109,142,1.324245375,0.024597035,80,-0.016655869,62,1.290322581,170
INDL,20170104,145,1.039837447,0.018752624,90,-0.017010773,55,1.636363636,170
CC,20170104,145,1.221960415,0.023167969,83,-0.017241395,62,1.338709677,163
VRTX,20170104,145,1.0567499,0.017772875,86,-0.012703031,59,1.457627119,154
ALGN,20170131,127,0.894420982,0.013979213,80,-0.009653588,47,1.70212766,152
ATHM,20170105,144,0.899255194,0.018005228,89,-0.016777416,55,1.618181818,145
CTRL,20170104,145,1.150283554,0.020801287,81,-0.013421745,64,1.265625,145
HTHT,20170110,141,1.031334583,0.021546759,82,-0.017114838,59,1.389830508,143
NRG,20170104,145,0.949593496,0.019207439,87,-0.016151249,58,1.5,142
GDEN,20170124,132,0.891917293,0.019559508,81,-0.017437557,51,1.588235294,141
LOXO,20170104,145,1.28115942,0.031509277,76,-0.020734129,69,1.101449275,141
AVXS,20170104,145,1.006136267,0.024684589,84,-0.021362392,61,1.37704918,138
PI,20170308,102,0.751461988,0.025648453,66,-0.029344098,36,1.833333333,137
IRBT,20170210,119,0.917854464,0.021359208,71,-0.016809634,48,1.479166667,135
OLED,20170120,134,1.089473684,0.022895647,74,-0.014722048,60,1.233333333,134
JKS,20170131,127,0.9296875,0.026223887,75,-0.023841618,52,1.442307692,134
LL,20170120,134,1.32345191,0.029284397,67,-0.014893499,67,1,132
JD,20170104,145,0.754474297,0.012629126,92,-0.010906542,53,1.735849057,130
ATVI,20170104,145,0.74685964,0.012155056,92,-0.01000874,53,1.735849057,129
FMI,20170104,145,1.04494382,0.026510282,80,-0.020414541,65,1.230769231,128
DRIP,20170105,144,1.01216545,0.041136556,80,-0.037605891,64,1.25,126
BCO,20170106,143,0.880145278,0.014462943,84,-0.009375772,59,1.423728814,125
MELI,20170104,145,0.81579928,0.014969593,87,-0.011598024,58,1.5,122
LABU,20170104,145,0.916536418,0.034312231,83,-0.03311805,62,1.338709677,122
WB,20170104,145,0.883995187,0.021371721,84,-0.017778536,61,1.37704918,121
CYOU,20170104,145,0.980055659,0.018660336,80,-0.011809656,65,1.230769231,120
HLT,20170104,145,1.267981015,0.025056219,70,-0.007461914,75,0.933333333,118
NVDA,20170417,75,0.743428631,0.022238707,46,-0.014899311,29,1.586206897,117
GASX,20170127,129,0.957962782,0.041125938,71,-0.036179403,58,1.224137931,117
EDC,20170104,145,0.830347349,0.019011601,85,-0.016237341,60,1.416666667,117
RACE,20170110,141,0.85895676,0.013405765,81,-0.007503921,60,1.35,115
FSLR,20170404,83,0.796429928,0.022546152,49,-0.014340023,34,1.441176471,114
HDB,20170104,145,0.661034133,0.009047122,92,-0.005954835,53,1.735849057,114
LVNTA,20170104,145,0.609756098,0.010181872,94,-0.00905709,51,1.843137255,112
WUBA,20170207,122,0.794642857,0.018206394,71,-0.013232485,51,1.392156863,110
SUPN,20170123,133,0.778251599,0.021135251,78,-0.018625792,55,1.418181818,110
SQ,20170104,145,0.826212889,0.017865299,83,-0.013531309,62,1.338709677,110
ANET,20170118,136,0.632664627,0.012357579,86,-0.010863451,50,1.72,108
TRVG,20170130,128,0.924460432,0.026976336,69,-0.019258873,59,1.169491525,108
BLQ,20170130,94,0.582701692,0.012499451,61,-0.008713805,33,1.848484848,107
TVTY,20170123,133,0.725,0.014661014,79,-0.010853219,54,1.462962963,106
TTD,20170104,145,1.023022651,0.029520014,74,-0.019363645,71,1.042253521,106
PEGA,20170105,144,0.695774648,0.013640548,87,-0.011086704,57,1.526315789,106
AXON,20170227,109,0.969283276,0.030680242,57,-0.019053344,52,1.096153846,106
OILU,20170622,29,0.473856209,0.038477199,22,-0.060068051,7,3.142857143,105
AKRX,20170131,127,0.831051479,0.014877691,71,-0.00739731,56,1.267857143,105
EURL,20170104,145,0.703758655,0.014654404,87,-0.012351006,58,1.5,105
NOVT,20170110,141,0.796650718,0.01588628,80,-0.010810677,61,1.31147541,104
SPDN,20170302,106,0.928819444,0.020506166,56,-0.003726633,50,1.12,104
NDRM,20170531,45,0.90617284,0.041402782,25,-0.016445337,20,1.25,104
TECK,20170619,32,0.451137885,0.019010532,24,-0.009561598,8,3,104
PRLB,20170405,82,0.516293279,0.014154349,55,-0.012878106,27,2.037037037,104
AMRI,20170324,90,0.660796325,0.016566108,55,-0.010669069,35,1.571428571,103
IAC,20170104,145,0.654655991,0.011268988,88,-0.008167699,57,1.543859649,101
TDOC,20170106,143,0.844512195,0.026061588,78,-0.020526416,65,1.2,101
GDOT,20170104,145,0.672450275,0.010646672,87,-0.006839913,58,1.5,100
NVMI,20170104,145,0.775075988,0.021258476,82,-0.017644087,63,1.301587302,100
NTRI,20170131,127,0.609302326,0.01940288,79,-0.020821483,48,1.645833333,100
WK,20170202,125,0.540322581,0.013280576,81,-0.014151022,44,1.840909091,99
TECL,20170104,145,0.6074348,0.013052263,90,-0.012301412,55,1.636363636,99
YY,20170105,144,0.944356955,0.022530636,74,-0.013716445,70,1.057142857,99
GBT,20170104,145,0.902097902,0.03483575,76,-0.027069706,69,1.101449275,99
CGNX,20170109,142,0.603857098,0.013001252,88,-0.011959168,54,1.62962963,98
VMIN,20170417,77,0.591355599,0.023645311,48,-0.021282769,29,1.655172414,97
EDU,20170104,145,0.814720812,0.019335795,79,-0.013498836,66,1.196969697,97
RNG,20170106,143,0.625882353,0.01515404,87,-0.014355064,56,1.553571429,97
TWOU,20170104,145,0.699189737,0.015074108,84,-0.011696412,61,1.37704918,96
TQQQ,20170113,138,0.566093994,0.013006914,87,-0.012944841,51,1.705882353,96
TTWO,20170104,145,0.81003657,0.014893761,79,-0.008434123,66,1.196969697,96
PAYC,20170202,125,0.579558388,0.013639062,78,-0.012404037,47,1.659574468,96
MMSI,20170131,127,0.672064777,0.015177543,75,-0.011573527,52,1.442307692,96
HOME,20170109,142,0.662518302,0.018545494,84,-0.017203009,58,1.448275862,95
BABA,20170104,145,0.730474041,0.012663922,82,-0.00746191,63,1.301587302,95
IPGP,20170109,142,0.677456647,0.013995411,83,-0.01051486,59,1.406779661,95
QDEL,20170127,129,0.704705246,0.01682553,74,-0.012010771,55,1.345454545,94
LITE,20170124,132,0.815406977,0.028922616,71,-0.022580028,61,1.163934426,94
EXEL,20170104,145,0.745417515,0.023816906,81,-0.020323227,64,1.265625,94
AAN,20170224,110,0.703194651,0.016397551,63,-0.009990975,47,1.340425532,94
LGIH,20170209,120,0.689416058,0.016723756,69,-0.011669045,51,1.352941176,93
OLLI,20170109,142,0.617594255,0.015153437,85,-0.013734301,57,1.49122807,92
FNFV,20170314,98,0.465811966,0.011620492,65,-0.010999236,33,1.96969697,91
SAFM,20170209,120,0.491140955,0.011127147,78,-0.010869258,42,1.857142857,91
DZK,20170104,145,0.583876575,0.012621109,88,-0.011093753,57,1.543859649,90
HRB,20170227,109,0.52319202,0.013049274,69,-0.011392502,40,1.725,90
BA,20170104,145,0.51780595,0.008676908,92,-0.006975735,53,1.735849057,89
KWEB,20170104,145,0.529144157,0.009509774,91,-0.007989145,54,1.685185185,89
SNC,20170214,117,0.621998451,0.013590126,69,-0.009125263,48,1.4375,89
BCOR,20170216,115,0.557093426,0.014379771,71,-0.012569643,44,1.613636364,89
NEFF,20170110,141,0.555555556,0.02178414,87,-0.025465813,54,1.611111111,89
ASR,20170120,134,0.58077009,0.015045502,81,-0.013908301,53,1.528301887,88
BPMC,20170104,145,0.65934636,0.023706313,83,-0.022452787,62,1.338709677,88
MOD,20170417,75,0.626213592,0.019619435,44,-0.011182413,31,1.419354839,88
FOXF,20170130,128,0.481335953,0.012541918,83,-0.013935044,45,1.844444444,88
INGN,20170120,134,0.554131054,0.01281737,82,-0.011407026,52,1.576923077,87
SOXL,20170106,143,0.632394868,0.025051494,83,-0.025203499,60,1.383333333,87
MZOR,20170127,129,0.759481517,0.027393697,69,-0.020847678,60,1.15,87
JOBS,20170104,145,0.497180172,0.011240392,92,-0.011569564,53,1.735849057,86
PRXL,20170417,75,0.432569558,0.009053475,50,-0.00346913,25,2,86
STM,20170109,142,0.609823911,0.017342795,83,-0.015783763,59,1.406779661,85
ATSG,20170124,132,0.648432288,0.016350321,75,-0.012140267,57,1.315789474,85
YINN,20170104,145,0.749198204,0.020938607,77,-0.014897177,68,1.132352941,84
BSET,20170327,89,0.496993988,0.018049751,56,-0.017575989,33,1.696969697,84
TNET,20170209,120,0.601153688,0.014211657,70,-0.009908013,50,1.4,84
APTI,20170406,81,0.581669691,0.018432395,48,-0.012348084,33,1.454545455,84
NEWR,20170104,145,0.560026828,0.014333297,87,-0.013348228,58,1.5,84
ACOR,20170601,44,0.576086957,0.025637486,27,-0.013016666,17,1.588235294,83
YRD,20170131,127,0.595588674,0.026385377,74,-0.026372299,53,1.396226415,83
CLVS,20170104,145,0.802793946,0.034644203,74,-0.025352308,71,1.042253521,83
ITGR,20170106,143,0.553846154,0.015448381,86,-0.015054286,57,1.50877193,83
TEAM,20170104,145,0.424390244,0.010441342,96,-0.012868928,49,1.959183673,83
BITA,20170223,111,0.708423326,0.025963422,60,-0.019048374,51,1.176470588,83
KRO,20170104,145,0.7063689,0.021586635,78,-0.016439602,67,1.164179104,82
SCSS,20170208,121,0.663082437,0.019949829,67,-0.014169993,54,1.240740741,82
MBLY,20170110,141,0.592824887,0.008979034,82,-0.003917888,59,1.389830508,82
MBUU,20170124,132,0.567850903,0.015078055,78,-0.013004003,54,1.444444444,82
EA,20170110,141,0.511317396,0.009929427,87,-0.008029619,54,1.611111111,82
ABCO,20170105,144,0.648729447,0.013295103,80,-0.008368958,64,1.25,81
SAGE,20170131,127,0.703977396,0.026275942,68,-0.020251675,59,1.152542373,81
VCRA,20170104,145,0.507381083,0.015457875,89,-0.016723641,56,1.589285714,80
FGEN,20170104,145,0.632941176,0.022658582,81,-0.020001844,64,1.265625,80
SODA,20170109,142,0.588583183,0.016090245,82,-0.013723858,60,1.366666667,80
XTLY,20170112,139,0.435779817,0.010052158,90,-0.010501678,49,1.836734694,80
COT,20170202,125,0.533077661,0.014063313,75,-0.012131021,50,1.5,79
WD,20170124,132,0.641135688,0.01801406,73,-0.013113573,59,1.237288136,79
SCIF,20170104,145,0.407786641,0.008948327,96,-0.010326352,49,1.959183673,79
OMCL,20170110,141,0.541213064,0.012312328,84,-0.010171824,57,1.473684211,79
HUBS,20170104,145,0.506792059,0.016404238,88,-0.017461081,57,1.543859649,78
TROX,20170104,145,0.752021563,0.029248506,74,-0.021007316,71,1.042253521,78
NKTR,20170131,127,0.705531915,0.030697555,67,-0.02307173,60,1.116666667,78
TSLA,20170104,145,0.5995668,0.018699896,82,-0.016248156,63,1.301587302,78
NORD,20170131,127,0.525850023,0.008915043,76,-0.004585548,51,1.490196078,78
ASMB,20170104,145,0.830188679,0.024868711,70,-0.014313247,75,0.933333333,77
TRUP,20170118,136,0.670740474,0.016852163,73,-0.010899331,63,1.158730159,77
SPNC,20170109,142,0.586597938,0.016025218,81,-0.012916433,61,1.327868852,77
MDSO,20170209,120,0.610625,0.01755039,67,-0.012554628,53,1.264150943,77
FNF,20170117,137,0.433580981,0.007115578,88,-0.005331366,49,1.795918367,77
ACH,20170104,145,0.627299129,0.020999729,80,-0.017655594,65,1.230769231,77
ISRG,20170105,144,0.48399498,0.00844275,88,-0.006041178,56,1.571428571,76
CACQ,20170104,145,0.480916031,0.013304114,89,-0.013683848,56,1.589285714,76
CYD,20170118,136,0.634513941,0.020391287,74,-0.015740906,62,1.193548387,75
TTEC,20170407,80,0.429809359,0.01268652,51,-0.009520726,29,1.75862069,75
EVH,20170104,145,0.593959732,0.022186501,81,-0.019914383,64,1.265625,75
RYAAY,20170308,102,0.48906687,0.010993383,62,-0.006880724,40,1.55,75
BLKB,20170209,120,0.41733806,0.009973029,77,-0.009352273,43,1.790697674,74
LMAT,20170224,110,0.538356164,0.02169008,64,-0.019259733,46,1.391304348,74
JUNO,20170118,136,0.523584906,0.027380039,80,-0.029889712,56,1.428571429,74
WRLD,20170203,124,0.602284747,0.020497233,68,-0.014794809,56,1.214285714,73
CALD,20170109,142,0.490797546,0.014703292,85,-0.014426882,57,1.49122807,73
BEAT,20170117,137,0.559440559,0.019471078,78,-0.017380635,59,1.322033898,73
CSGP,20170104,145,0.47746441,0.009035954,88,-0.006916763,57,1.543859649,73
AMX,20170208,121,0.46875,0.012357948,74,-0.010976596,47,1.574468085,73
NEP,20170104,145,0.562862669,0.011620569,82,-0.007727797,63,1.301587302,73
LOGI,20170104,145,0.464845319,0.012282116,89,-0.01219608,56,1.589285714,73
SOHU,20170104,145,0.585537423,0.016724085,80,-0.01295086,65,1.230769231,72
COHR,20170104,145,0.587377217,0.019988156,80,-0.016303528,65,1.230769231,72
PENN,20170120,134,0.555130168,0.01604991,76,-0.012947252,58,1.310344828,72
PYPL,20170202,125,0.486135843,0.010561122,75,-0.007716273,50,1.5,72
AGIO,20170131,127,0.556158973,0.023109288,72,-0.021125427,55,1.309090909,72
APTS,20170315,97,0.425241158,0.012431726,61,-0.010808276,36,1.694444444,72
BRZU,20170621,30,0.575773657,0.030182843,19,-0.009463287,11,1.727272727,72
IXYS,20170111,140,0.352678571,0.010764696,94,-0.014894005,46,2.043478261,72
BBY,20170302,106,0.416468913,0.013600922,67,-0.013565151,39,1.717948718,71
SPGI,20170104,145,0.401605314,0.007093969,93,-0.006082588,52,1.788461538,71
QIWI,20170120,134,0.56440678,0.019600791,75,-0.016631219,59,1.271186441,71
PAM,20170104,145,0.5575,0.016230472,81,-0.013174851,64,1.265625,70
OTIC,20170406,81,0.534782609,0.02533691,46,-0.020021046,35,1.314285714,70
SCHN,20170420,72,0.42776204,0.018855817,45,-0.017418858,27,1.666666667,70
DAN,20170417,75,0.356289129,0.011796059,50,-0.01108304,25,2,70
WGO,20170601,44,0.436734694,0.02357249,28,-0.017266504,16,1.75,70
ALRM,20170127,129,0.431536039,0.012481851,80,-0.012672317,49,1.632653061,70
MPX,20170313,99,0.461077844,0.019184147,60,-0.019079377,39,1.538461538,70
LBJ,20170519,51,0.478629808,0.024522237,31,-0.01730485,20,1.55,70
SINA,20170104,145,0.555842896,0.01716886,81,-0.014050033,64,1.265625,70
IVC,20170411,78,0.490384615,0.023831277,46,-0.019902072,32,1.4375,70
NYT,20170124,132,0.46743295,0.011963215,79,-0.010142996,53,1.490566038,69
FOR,20170209,120,0.376,0.008849705,78,-0.008463207,42,1.857142857,69
DATA,20170104,145,0.611265005,0.015087448,77,-0.009621381,68,1.132352941,69
VEC,20170303,105,0.566870014,0.020108735,58,-0.014613921,47,1.234042553,69
PGJ,20170104,145,0.452092701,0.00895935,88,-0.007134945,57,1.543859649,69
CURE,20170125,131,0.522603978,0.013733813,75,-0.010595712,56,1.339285714,69
COO,20170104,145,0.397544961,0.007564139,92,-0.006636538,53,1.735849057,69
CSIQ,20170327,89,0.489686099,0.020577222,52,-0.017389034,37,1.405405405,68
VEEV,20170104,145,0.509310762,0.013704697,83,-0.01135177,62,1.338709677,68
SITE,20170104,145,0.45968645,0.010870839,87,-0.009544277,58,1.5,68
ADBE,20170104,145,0.428198686,0.007546872,89,-0.005512314,56,1.589285714,68
RGLD,20170310,100,0.411065907,0.012134708,62,-0.010410445,38,1.631578947,67
FGL,20170202,125,0.319238901,0.005524473,85,-0.004630245,40,2.125,67
RHT,20170104,145,0.400313748,0.008707282,91,-0.008181809,54,1.685185185,67
TPX,20170418,74,0.438639724,0.018128713,45,-0.014873561,29,1.551724138,67
CMTL,20170124,132,0.673239437,0.021777811,66,-0.013070246,66,1,67
DDS,20170515,55,0.535052205,0.03076114,31,-0.020579705,24,1.291666667,67
CDNS,20170104,145,0.428966062,0.008776454,88,-0.007030426,57,1.543859649,66
CHEF,20170707,20,0.233333333,0.016241791,17,-0.020553125,3,5.666666667,66
KRNT,20170106,143,0.6,0.026976482,75,-0.021551632,68,1.102941176,66
EHTH,20170106,143,0.653179191,0.023747929,72,-0.016024414,71,1.014084507,66
FSS,20170417,75,0.396958175,0.011753685,47,-0.007454991,28,1.678571429,66
EET,20170104,145,0.50982244,0.013464331,82,-0.010701345,63,1.301587302,66
ASIX,20170113,138,0.578971963,0.021944478,74,-0.017506849,64,1.15625,66
MYGN,20170208,121,0.575324675,0.017734522,65,-0.011768422,56,1.160714286,66
TPRE,20170123,133,0.342342342,0.008695284,88,-0.010228002,45,1.955555556,66
EXPE,20170104,145,0.36677339,0.008328548,93,-0.008714943,52,1.788461538,65
ACHC,20170104,145,0.598358164,0.016787852,76,-0.011267121,69,1.101449275,65
FIVN,20170104,145,0.506694856,0.018811007,82,-0.017112575,63,1.301587302,65
TDG,20170327,89,0.333698343,0.010253218,59,-0.010286716,30,1.966666667,65
PCTY,20170203,124,0.474264706,0.01658645,72,-0.014763446,52,1.384615385,65
CG,20170310,100,0.4,0.013107622,62,-0.012141456,38,1.631578947,65
RGEN,20170126,130,0.437890354,0.013211617,78,-0.012342806,52,1.5,65
WYN,20170118,136,0.34729356,0.007841648,89,-0.00827294,47,1.893617021,65
APO,20170104,145,0.464939024,0.01217254,85,-0.010590637,60,1.416666667,65
HCC,20170622,29,0.411233054,0.021814348,20,-0.009359478,9,2.222222222,64
MTD,20170124,132,0.393515391,0.007818499,82,-0.006021693,50,1.64,64
CTRP,20170104,145,0.418127933,0.011024755,88,-0.010626645,57,1.543859649,64
INST,20170104,145,0.54040404,0.014152251,79,-0.010092497,66,1.196969697,64
MRCY,20170109,142,0.488199595,0.014087899,81,-0.011821307,61,1.327868852,64
INXN,20170104,145,0.418134565,0.008193576,88,-0.00639279,57,1.543859649,64
SNI,20170606,41,0.336318106,0.015345284,28,-0.009697495,13,2.153846154,64
UBNT,20170509,59,0.355325571,0.015693315,38,-0.013008995,21,1.80952381,63
ALXN,20170530,46,0.399385875,0.017840417,29,-0.010052319,17,1.705882353,63
TRUE,20170104,145,0.502797762,0.016269388,81,-0.013742678,64,1.265625,63
KOLD,20170127,129,0.47311564,0.028886357,74,-0.030133755,55,1.345454545,63
MIME,20170104,145,0.59124928,0.023050793,75,-0.017261574,70,1.071428571,63
WDAY,20170104,145,0.476016379,0.013319114,83,-0.011154961,62,1.338709677,63
FMC,20170208,121,0.461336139,0.012149576,70,-0.008837708,51,1.37254902,63
MLQ,20170123,92,0.276662278,0.005715134,64,-0.004217738,28,2.285714286,63
ENTL,20170508,60,0.396179402,0.017282495,37,-0.012790082,23,1.608695652,62
NOW,20170104,145,0.41580756,0.01119503,87,-0.010512434,58,1.5,62
ATRC,20170124,132,0.504016064,0.015511291,73,-0.011843168,59,1.237288136,62
MOH,20170324,90,0.459484778,0.016302537,52,-0.011629774,38,1.368421053,62
VRNS,20170109,142,0.403738318,0.011426994,86,-0.011102953,56,1.535714286,62
CTSH,20170203,124,0.353521672,0.007366376,79,-0.006066511,45,1.755555556,62
BCR,20170127,129,0.409648658,0.006590836,78,-0.002967997,51,1.529411765,62
AVA,20170202,125,0.375724829,0.00841057,78,-0.00669135,47,1.659574468,62
TRU,20170104,145,0.478359173,0.009844949,82,-0.006431063,63,1.301587302,62
SNOW,20170113,138,0.39952858,0.010677058,84,-0.009866219,54,1.555555556,62
FOE,20170310,100,0.417340191,0.013044689,60,-0.010502217,40,1.5,62
UL,20170127,129,0.400148112,0.008666317,78,-0.006328731,51,1.529411765,61
PNK,20170120,134,0.400874636,0.012869015,81,-0.012958044,53,1.528301887,61
HOFT,20170323,91,0.399665552,0.01699436,55,-0.015391152,36,1.527777778,61
IT,20170106,143,0.408568905,0.007858051,86,-0.005724071,57,1.50877193,61
FSTR,20170328,88,0.405737705,0.022504794,53,-0.023020426,35,1.514285714,61
MSCI,20170104,145,0.419260577,0.009526575,86,-0.007771569,59,1.457627119,61
YUMC,20170316,96,0.423433875,0.01490855,57,-0.012096893,39,1.461538462,61
TUR,20170112,139,0.465954606,0.012947673,79,-0.010392871,60,1.316666667,61
CAR,20170606,41,0.444962687,0.031012413,25,-0.023558996,16,1.5625,61
CUTR,20170104,145,0.47277937,0.017283986,82,-0.015734025,63,1.301587302,61
PAHC,20170131,127,0.501908397,0.01532138,70,-0.01133785,57,1.228070175,61
QLYS,20170104,145,0.425499232,0.014533477,85,-0.014157333,60,1.416666667,60
ABMD,20170203,124,0.420653218,0.010628566,73,-0.008122087,51,1.431372549,60
SCOR,20170313,99,0.412015137,0.011065925,59,-0.007439095,40,1.475,60
BNFT,20170227,109,0.378486056,0.014644763,67,-0.015168191,42,1.595238095,60
ILG,20170118,136,0.504761905,0.011921636,74,-0.007436356,62,1.193548387,60
UBIO,20170125,131,0.493194192,0.025271127,72,-0.022972127,59,1.220338983,60
SQM,20170104,145,0.455647956,0.014259839,83,-0.012694471,62,1.338709677,60
UCO,20170111,140,0.575815739,0.036880368,72,-0.026325114,68,1.058823529,60
HF,20170328,88,0.418515685,0.01282578,52,-0.008422877,36,1.444444444,60
HSC,20170420,72,0.424892704,0.023845146,42,-0.020360181,30,1.4,59
TSU,20170104,145,0.417073171,0.013741905,85,-0.013177775,60,1.416666667,59
KAI,20170323,91,0.489025461,0.01748859,50,-0.010883103,41,1.219512195,59
TRCO,20170127,129,0.430638899,0.010890886,75,-0.008194242,54,1.388888889,59
UN,20170127,129,0.445492923,0.009542218,74,-0.005808189,55,1.345454545,59
FB,20170104,145,0.443160418,0.008554878,83,-0.005420767,62,1.338709677,59
AVAV,20170124,132,0.48,0.014747654,73,-0.011161123,59,1.237288136,59
IRTC,20170119,135,0.503910235,0.018245459,73,-0.014349312,62,1.177419355,59
BLDR,20170201,126,0.416356877,0.01555273,74,-0.014899558,52,1.423076923,59
LJPC,20170223,111,0.814378315,0.046153601,47,-0.020317777,64,0.734375,59
PCLN,20170104,145,0.37251027,0.007164699,89,-0.005599302,56,1.589285714,59
GIII,20170519,51,0.402007396,0.023187303,31,-0.017820158,20,1.55,59
LBRDA,20170104,145,0.382724719,0.008972009,88,-0.007933235,57,1.543859649,59
EEFT,20170203,124,0.364644763,0.008251131,77,-0.006747644,47,1.638297872,59
HRI,20170519,51,0.286203942,0.015916305,35,-0.01833559,16,2.1875,59
REMX,20170420,72,0.336358137,0.010988344,46,-0.008073314,26,1.769230769,59
FCFS,20170131,127,0.383512545,0.009277787,77,-0.007630807,50,1.54,59
BRF,20170104,145,0.361026268,0.011135929,90,-0.012201449,55,1.636363636,59
GWRE,20170111,140,0.399764382,0.010178288,83,-0.00870604,57,1.456140351,58
ASCMA,20170519,51,0.394238683,0.020971356,31,-0.015070795,20,1.55,58
KB,20170110,141,0.443191429,0.012746609,80,-0.010431187,61,1.31147541,58
SOCL,20170104,145,0.35472044,0.00774477,90,-0.007021733,55,1.636363636,58
ENTG,20170110,141,0.386740331,0.013402726,85,-0.014092111,56,1.517857143,58
PKX,20170110,141,0.446047431,0.015183983,80,-0.013394544,61,1.31147541,58
AVGO,20170106,143,0.43613725,0.011374525,82,-0.009097345,61,1.344262295,58
G,20170407,80,0.283269148,0.007159511,54,-0.005156981,26,2.076923077,58
WFM,20170328,88,0.466526463,0.014869881,49,-0.007682615,39,1.256410256,58
VAC,20170111,140,0.441304078,0.012450243,79,-0.009835442,61,1.295081967,57
DFT,20170104,145,0.419792137,0.011054088,84,-0.009201485,61,1.37704918,57
NOAH,20170110,141,0.439013248,0.015410207,80,-0.013815215,61,1.31147541,57
SXCP,20170322,92,0.339416058,0.015271027,58,-0.016677391,34,1.705882353,57
AET,20170131,127,0.358409734,0.007946468,78,-0.006281855,49,1.591836735,57
CPA,20170110,141,0.392288257,0.011831465,84,-0.011272988,57,1.473684211,57
CNC,20170104,145,0.42668496,0.012987064,83,-0.011359206,62,1.338709677,57
RCL,20170104,145,0.429661421,0.010209508,83,-0.007681694,62,1.338709677,57
CACC,20170324,90,0.464314614,0.016255824,50,-0.010377279,40,1.25,57
NTNX,20170502,64,0.451590595,0.028482435,36,-0.021969921,28,1.285714286,57
SPR,20170519,51,0.359516616,0.013841096,32,-0.006287421,19,1.684210526,57
PGTI,20170301,107,0.353233831,0.012368169,66,-0.012180559,41,1.609756098,56
Z,20170329,87,0.378870674,0.015094969,52,-0.012757081,35,1.485714286,56
ZG,20170329,87,0.379758308,0.014358151,52,-0.011667584,35,1.485714286,56
CARB,20170109,142,0.501607717,0.019819798,75,-0.015464202,67,1.119402985,56
ECPG,20170109,142,0.356890459,0.01264804,87,-0.014055352,55,1.581818182,56
MMYT,20170104,145,0.456140351,0.02076882,80,-0.018979872,65,1.230769231,56
RICE,20170228,108,0.47311828,0.021304711,59,-0.016690173,49,1.204081633,56
HZN,20170411,78,0.489812551,0.020613723,42,-0.011923171,36,1.166666667,56
LOPE,20170209,120,0.421311764,0.012287081,69,-0.00941832,51,1.352941176,56
TEO,20170106,143,0.541111111,0.018451596,73,-0.012515714,70,1.042857143,56
PNQI,20170104,145,0.316487455,0.006307625,93,-0.005895248,52,1.788461538,56
MCHI,20170104,145,0.344365241,0.006690296,90,-0.005480237,55,1.636363636,56
BL,20170113,138,0.414809218,0.014522871,79,-0.01319621,59,1.338983051,55
LYV,20170110,141,0.367533895,0.008651873,85,-0.007366674,56,1.517857143,55
NATI,20170118,136,0.343431017,0.008306843,84,-0.007601136,52,1.615384615,55
ACLS,20170104,145,0.462897527,0.020667963,79,-0.018248614,66,1.196969697,55
SWIR,20170123,133,0.481012658,0.024178269,71,-0.019457894,62,1.14516129,55
KBH,20170215,116,0.434512725,0.012119206,65,-0.008140262,51,1.274509804,55
ROG,20170104,145,0.493960255,0.015849852,77,-0.011598284,68,1.132352941,55
ILMN,20170104,145,0.513459925,0.014125127,75,-0.008727223,70,1.071428571,55
ONCE,20170412,77,0.546314942,0.032053222,39,-0.020041317,38,1.026315789,55
LRCX,20170106,143,0.390549122,0.011757223,84,-0.010869967,59,1.423728814,55
ADSK,20170104,145,0.416119716,0.012844807,83,-0.011188187,62,1.338709677,55
VFC,20170208,121,0.308567881,0.00921515,78,-0.010208923,43,1.813953488,55
ASML,20170105,144,0.384370451,0.010573113,85,-0.009480833,59,1.440677966,55
BREW,20170419,73,0.412244898,0.022282625,42,-0.017701219,31,1.35483871,55
AON,20170202,125,0.250067464,0.005139057,86,-0.005535482,39,2.205128205,55
ANSS,20170202,125,0.323359073,0.007487992,79,-0.006595035,46,1.717391304,55
MCRI,20170124,132,0.410905968,0.013588686,75,-0.011374068,57,1.315789474,54
TER,20170104,145,0.312450749,0.010428387,92,-0.012606133,53,1.735849057,54
JBL,20170118,136,0.33492823,0.009881942,84,-0.010177681,52,1.615384615,54
BAX,20170104,145,0.340909091,0.007052549,89,-0.005865969,56,1.589285714,54
YAO,20170104,130,0.317401961,0.007180482,82,-0.00641501,48,1.708333333,54
ATHN,20170501,65,0.445566779,0.021493034,36,-0.012780132,29,1.24137931,54
HCCI,20170323,91,0.43129771,0.018810391,51,-0.014242492,40,1.275,54
LBRDK,20170104,145,0.366456217,0.008714769,87,-0.0074781,58,1.5,54
WIX,20170104,145,0.395995551,0.021349893,84,-0.022705738,61,1.37704918,54
XLRN,20170209,120,0.425751073,0.024977211,67,-0.023561304,53,1.264150943,53
PHM,20170109,142,0.369989166,0.009089242,84,-0.007562598,58,1.448275862,53
PPC,20170111,140,0.380327869,0.011061488,82,-0.00975772,58,1.413793103,53
GRUB,20170403,84,0.46701125,0.017374581,45,-0.009382859,39,1.153846154,53
ZNH,20170104,143,0.447157573,0.016133643,78,-0.013255018,65,1.2,53
RP,20170120,134,0.417699115,0.013698862,75,-0.01115944,59,1.271186441,53
PRO,20170120,134,0.411478599,0.014855856,76,-0.013160607,58,1.310344828,53
ING,20170301,107,0.347794649,0.01104777,65,-0.009701595,42,1.547619048,53
FORM,20170419,73,0.353773585,0.024132375,44,-0.024335547,29,1.517241379,53
PEGI,20170104,145,0.325224749,0.008138986,90,-0.008047357,55,1.636363636,53
HPQ,20170119,135,0.327846365,0.008971568,84,-0.008968771,51,1.647058824,53
SNCR,20170621,30,0.634577603,0.04153632,16,-0.008202692,14,1.142857143,53
MCO,20170111,140,0.359776064,0.007376492,84,-0.005475456,56,1.5,53
GLOG,20170601,44,0.266409266,0.01814866,30,-0.020946622,14,2.142857143,52
XPP,20170104,144,0.479262673,0.014616144,75,-0.009941146,69,1.086956522,52
AMT,20170131,127,0.331424134,0.007555974,78,-0.006081035,49,1.591836735,52
CHAU,20170104,145,0.379192723,0.01189733,84,-0.010836058,61,1.37704918,52
EXLS,20170207,122,0.293706294,0.007678006,78,-0.007564885,44,1.772727273,52
LILA,20170621,30,0.309760956,0.017197202,21,-0.009269251,9,2.333333333,52
IFN,20170105,144,0.34549763,0.006853325,87,-0.005170928,57,1.526315789,52
BLD,20170120,134,0.453790814,0.012372843,72,-0.008089063,62,1.161290323,52
MCD,20170105,144,0.294944761,0.005574552,92,-0.004790445,52,1.769230769,52
EPI,20170104,145,0.308126688,0.006521387,91,-0.005924474,54,1.685185185,51
SILC,20170223,111,0.48441449,0.019988428,57,-0.012906913,54,1.055555556,51
BLUE,20170104,145,0.510517799,0.028008573,73,-0.021558551,72,1.013888889,51
CRVL,20170123,133,0.322845417,0.011460721,82,-0.012657245,51,1.607843137,51
IGV,20170104,145,0.287636364,0.005986583,93,-0.005752267,52,1.788461538,51
RCI,20170112,139,0.340077821,0.007895162,84,-0.00660902,55,1.527272727,51
GGG,20170106,143,0.36349454,0.008975528,84,-0.007293589,59,1.423728814,51
TCX,20170120,134,0.469050894,0.018622124,70,-0.013645174,64,1.09375,51
SNPS,20170104,145,0.281576288,0.006069452,94,-0.00618739,51,1.843137255,51
CBD,20170310,100,0.402712264,0.018832253,56,-0.015322716,44,1.272727273,51
LILAK,20170621,30,0.300858152,0.015435624,21,-0.005868127,9,2.333333333,51
REXR,20170315,97,0.302228412,0.00883422,61,-0.007491966,36,1.694444444,51
HGV,20170118,136,0.474189676,0.014728704,71,-0.009858864,65,1.092307692,51
COR,20170104,145,0.352933879,0.0093247,86,-0.008301593,59,1.457627119,51
CVGW,20170307,103,0.446289062,0.014935425,55,-0.009089674,48,1.145833333,51
ERI,20170131,127,0.347682119,0.014863109,76,-0.015790735,51,1.490196078,51
TAO,20170104,145,0.371232394,0.008067483,84,-0.005832708,61,1.37704918,51
CYTK,20170131,127,0.343283582,0.021636573,76,-0.025185851,51,1.490196078,51
BOBE,20170118,136,0.395115842,0.014520416,77,-0.012639589,59,1.305084746,51
SWKS,20170106,143,0.36502615,0.011923448,83,-0.010936789,60,1.383333333,50
MYCC,20170707,20,0.338582677,0.02318366,15,-0.003520817,5,3,50
DECK,20170208,121,0.43187375,0.01575318,65,-0.011267409,56,1.160714286,50
IDXX,20170105,144,0.328934886,0.009523371,87,-0.009196464,57,1.526315789,50
ASPS,20170509,59,0.327566964,0.023598465,36,-0.023113103,23,1.565217391,50
ARCB,20170518,52,0.450581395,0.02807778,28,-0.015604734,24,1.166666667,50
AFSI,20170518,52,0.325814536,0.021132922,32,-0.01852744,20,1.6,50
WYNN,20170104,145,0.444050749,0.015080683,77,-0.011300152,68,1.132352941,50
RILY,20170518,52,0.357664234,0.020817074,31,-0.015426514,21,1.476190476,50
EVBG,20170309,101,0.373020528,0.018243561,58,-0.01660211,43,1.348837209,50
TEX,20170328,88,0.318904295,0.016063775,54,-0.016782411,34,1.588235294,50
BOTZ,20170104,145,0.325827815,0.005777601,88,-0.003915752,57,1.543859649,50
RAVN,20170118,136,0.435789474,0.017211667,73,-0.013698063,63,1.158730159,50
BSAC,20170202,125,0.368445693,0.009570693,72,-0.006923499,53,1.358490566,50
CVCO,20170120,134,0.447689857,0.014580554,71,-0.010168314,63,1.126984127,50
SNE,20170104,145,0.420996819,0.010404716,79,-0.006964362,66,1.196969697,50
CEVA,20170109,142,0.391035549,0.016193481,80,-0.015044668,62,1.290322581,50
PRAH,20170125,131,0.360764144,0.011169638,76,-0.009596561,55,1.381818182,49
MKSI,20170104,145,0.284043442,0.011973183,92,-0.015588843,53,1.735849057,49
MGPI,20170131,127,0.392072588,0.015540221,71,-0.013284238,56,1.267857143,49
HAIN,20170626,27,0.373101266,0.022164483,18,-0.0080341,9,2,49
CHIQ,20170104,144,0.34185022,0.007460979,85,-0.005681889,59,1.440677966,49
SRPT,20170214,117,0.368991688,0.023479664,67,-0.023920748,50,1.34,49
WBMD,20170130,128,0.374870413,0.009795858,73,-0.006736437,55,1.327272727,49
FEYE,20170315,97,0.396153846,0.017960707,54,-0.014125852,43,1.255813953,49
INDA,20170104,148,0.284069811,0.006433003,93,-0.00624184,55,1.690909091,48
INOV,20170104,145,0.29468599,0.014071249,90,-0.01773612,55,1.636363636,48
FTAI,20170105,144,0.328655835,0.009132967,86,-0.008445471,58,1.482758621,48
NFQ,20170420,72,0.278220641,0.012633522,46,-0.012322058,26,1.769230769,48
INCR,20170504,62,0.356968215,0.016957149,36,-0.010773605,26,1.384615385,48
DBVT,20170420,72,0.408950617,0.018642985,39,-0.011239733,33,1.181818182,48
FMX,20170110,141,0.342229411,0.010275839,83,-0.009431009,58,1.431034483,48
AAWW,20170519,51,0.416621401,0.020149885,28,-0.008816172,23,1.217391304,48
GTN,20170118,136,0.353233831,0.016970462,79,-0.017618657,57,1.385964912,48
NNBR,20170118,136,0.474719101,0.019136919,69,-0.013344459,67,1.029850746,48
PICK,20170621,30,0.200478278,0.009641356,23,-0.005273545,7,3.285714286,48
EWN,20170104,145,0.27897351,0.005338752,92,-0.004555338,53,1.735849057,48
MTN,20170104,145,0.321406386,0.008511862,87,-0.007816631,58,1.5,48
CHTR,20170104,145,0.344787766,0.010091748,84,-0.00879525,61,1.37704918,47
IONS,20170406,81,0.345819045,0.022275214,47,-0.021079568,34,1.382352941,47
BRKS,20170104,145,0.362110312,0.017307793,82,-0.016900706,63,1.301587302,47
BMI,20170310,100,0.293352601,0.010552559,62,-0.0101228,38,1.631578947,47
DCT,20170131,127,0.277501132,0.007310048,80,-0.00711938,47,1.70212766,47
RICK,20170120,134,0.374538745,0.01551378,75,-0.013846031,59,1.271186441,47
NAV,20170417,75,0.333770205,0.022049026,44,-0.020995571,31,1.419354839,47
NLY,20170104,145,0.205357143,0.005612903,101,-0.00849642,44,2.295454545,47
PHG,20170209,120,0.314443677,0.008753079,72,-0.007243552,48,1.5,47
BOX,20170104,145,0.326256192,0.013562393,86,-0.014474472,59,1.457627119,47
UHT,20170323,91,0.27112148,0.009634994,58,-0.00944851,33,1.757575758,47
GXC,20170104,145,0.332369544,0.006990461,85,-0.005044569,60,1.416666667,47
INP,20170104,145,0.3238111,0.007005954,86,-0.00537423,59,1.457627119,47
BTU,20170626,27,0.248587571,0.017626406,20,-0.017610271,7,2.857142857,47
CSX,20170104,145,0.373188406,0.013861867,81,-0.011965549,64,1.265625,47
EWH,20170104,145,0.243434343,0.00482004,95,-0.004742777,50,1.9,46
CCE,20170104,145,0.38571884,0.008993501,79,-0.005712447,66,1.196969697,46
PFGC,20170207,122,0.273972603,0.009508959,77,-0.010619548,45,1.711111111,46
MASI,20170104,145,0.285756677,0.010995151,90,-0.012884665,55,1.636363636,46
ALB,20170104,145,0.34923339,0.010582263,83,-0.009087491,62,1.338709677,46
WOOF,20170104,145,0.318104184,0.004159434,86,-0.000807564,59,1.457627119,46
PODD,20170106,143,0.354515955,0.01508527,81,-0.014330685,62,1.306451613,46
CPSI,20170207,122,0.396313364,0.015285323,66,-0.011471594,56,1.178571429,46
AAXJ,20170104,145,0.277447269,0.005314248,91,-0.004365413,54,1.685185185,46
KOF,20170120,134,0.374394926,0.01219597,74,-0.0095204,60,1.233333333,46
AMAT,20170104,145,0.337300345,0.011155829,84,-0.01034143,61,1.37704918,46
EWI,20170227,109,0.303448276,0.008796149,66,-0.007172014,43,1.534883721,46
INFO,20170104,145,0.298997773,0.006700585,88,-0.005657329,57,1.543859649,46
SHEN,20170308,102,0.350096712,0.016998288,58,-0.015067839,44,1.318181818,46
CBOE,20170104,145,0.30105465,0.007147301,87,-0.006077551,58,1.5,45
BIDU,20170327,89,0.351420421,0.012885282,50,-0.008487464,39,1.282051282,45
AKAO,20170104,145,0.403076923,0.031909176,77,-0.029359144,68,1.132352941,45
USCR,20170224,110,0.324508967,0.014666264,64,-0.013714918,46,1.391304348,45
HASI,20170207,122,0.303532009,0.010078219,73,-0.009421255,49,1.489795918,45
AAPL,20170105,144,0.340889502,0.00808669,82,-0.005819746,62,1.322580645,45
CDW,20170131,127,0.260775862,0.007731982,81,-0.008384565,46,1.760869565,45
HSBC,20170420,72,0.260005034,0.007970512,46,-0.005062957,26,1.769230769,45
NFLX,20170104,145,0.405835752,0.013228655,77,-0.009611998,68,1.132352941,45
PVH,20170208,121,0.418694431,0.012788982,63,-0.007628276,58,1.086206897,45
CRY,20170420,72,0.273972603,0.013713776,45,-0.013330338,27,1.666666667,45
ICLR,20170104,145,0.421898006,0.012724925,75,-0.008376878,70,1.071428571,45
ROL,20170113,138,0.336979641,0.008879842,79,-0.006832221,59,1.338983051,45
VRSN,20170104,145,0.294140473,0.006782978,88,-0.005858423,57,1.543859649,45
ARCH,20170621,30,0.224064347,0.014873434,22,-0.014945753,8,2.75,45
BWXT,20170104,145,0.350841407,0.008621599,82,-0.006291419,63,1.301587302,45
CRL,20170104,145,0.300143734,0.008016491,87,-0.007335149,58,1.5,45
SSNC,20170104,145,0.329289428,0.00918281,83,-0.007528721,62,1.338709677,44
KT,20170111,140,0.299855491,0.009656523,84,-0.009588152,56,1.5,44
VWR,20170124,132,0.32983871,0.007838765,76,-0.005206854,56,1.357142857,44
MTOR,20170104,145,0.407638348,0.016335259,76,-0.012639595,69,1.101449275,44
GLPI,20170313,99,0.263957714,0.006635021,62,-0.004707965,37,1.675675676,44
VSM,20170120,134,0.337565347,0.012665164,76,-0.011302442,58,1.310344828,44
SKM,20170104,145,0.342054264,0.010468243,82,-0.008752057,63,1.301587302,44
RTRX,20170601,44,0.276971609,0.016297869,28,-0.012719533,16,1.75,44
HFC,20170601,44,0.278661088,0.01809426,28,-0.01566183,16,1.75,44
COHU,20170209,120,0.35316847,0.018990526,67,-0.017381525,53,1.264150943,44
XPO,20170124,132,0.361039569,0.016507318,73,-0.01472378,59,1.237288136,44
PIN,20170104,145,0.27837699,0.006099114,89,-0.005236872,56,1.589285714,44
WWW,20170207,122,0.317316841,0.012819837,71,-0.012099058,51,1.392156863,44
VSAR,20170131,127,0.361538462,0.026511475,70,-0.025812219,57,1.228070175,44
CI,20170104,145,0.297155909,0.007561983,87,-0.006747713,58,1.5,44
LIVN,20170104,145,0.3309797,0.009998074,83,-0.008596359,62,1.338709677,44
KRA,20170131,127,0.372215931,0.015162017,69,-0.012234924,58,1.189655172,44
CERN,20170109,142,0.337118822,0.009722432,81,-0.007951326,61,1.327868852,44
LOB,20170104,145,0.338842975,0.014817183,82,-0.014260567,63,1.301587302,44
ALL,20170110,141,0.285127924,0.005779314,86,-0.004404116,55,1.563636364,44
CUK,20170104,145,0.325717633,0.007355051,84,-0.005422484,61,1.37704918,44
YNDX,20170104,145,0.427312775,0.019173009,73,-0.013861844,72,1.013888889,43
BIVV,20170210,119,0.443632075,0.019598594,59,-0.012719396,60,0.983333333,43
GLOB,20170112,139,0.404069767,0.016409828,72,-0.012174133,67,1.074626866,43
LORL,20170417,75,0.259158752,0.010439485,47,-0.009060521,28,1.678571429,43
PRTK,20170131,127,0.343859649,0.023617281,71,-0.023267511,56,1.267857143,43
DAR,20170131,127,0.402575107,0.013746577,66,-0.008999628,61,1.081967213,43
FCA,20170110,95,0.327506427,0.01172779,54,-0.008343639,41,1.317073171,43
RLGY,20170124,132,0.339236521,0.012180647,74,-0.010246782,58,1.275862069,43
WCG,20170105,144,0.335870599,0.009665308,81,-0.007670386,63,1.285714286,43
SBAC,20170111,140,0.348538012,0.00862169,78,-0.005924098,62,1.258064516,43
BIO,20170104,145,0.324585862,0.008436483,83,-0.00663818,62,1.338709677,43
MGI,20170124,132,0.349016253,0.010492627,73,-0.00725781,59,1.237288136,43
AMWD,20170120,134,0.353571429,0.012745986,74,-0.010417685,60,1.233333333,43
ARTNA,20170113,138,0.350984386,0.015112138,76,-0.01329639,62,1.225806452,43
HLF,20170104,145,0.330554991,0.012328878,82,-0.01114146,63,1.301587302,43
PIZ,20170104,145,0.229263747,0.004579328,95,-0.004521237,50,1.9,43
OI,20170104,145,0.36545961,0.011348898,79,-0.008670457,66,1.196969697,43
DLPH,20170104,145,0.374888955,0.01215141,78,-0.00911861,67,1.164179104,43
GRC,20170601,44,0.222683839,0.012309806,30,-0.011313507,14,2.142857143,43
TVPT,20170406,81,0.256993007,0.010262539,51,-0.009594584,30,1.7,43
IBP,20170202,125,0.331677019,0.013006369,71,-0.011389679,54,1.314814815,43
AMID,20170622,29,0.276785714,0.021570892,20,-0.01975712,9,2.222222222,43
WIFI,20170301,107,0.384051329,0.016894551,57,-0.012252376,50,1.14,43
NVO,20170309,101,0.28835658,0.011032494,61,-0.010237725,40,1.525,43
MCHP,20170106,143,0.289023806,0.010236764,86,-0.010750254,57,1.50877193,43
SSYS,20170106,143,0.308753166,0.017257003,84,-0.019135402,59,1.423728814,43
AZUL,20170524,49,0.316748768,0.017979563,29,-0.011770681,20,1.45,43
INDY,20170104,145,0.307439825,0.006663244,85,-0.004900147,60,1.416666667,43
KALU,20170310,100,0.29283614,0.01147774,60,-0.010501752,40,1.5,43
CCL,20170104,145,0.293057154,0.007199258,87,-0.006270681,58,1.5,43
WAT,20170105,144,0.314930991,0.008315729,83,-0.006669969,61,1.360655738,42
HRC,20170106,143,0.326109937,0.009472312,81,-0.007663766,62,1.306451613,42
CWST,20170217,114,0.398214286,0.015858332,59,-0.010534462,55,1.072727273,42
HRTX,20170130,128,0.313253012,0.023701057,74,-0.026232223,54,1.37037037,42
CHUBK,20170124,132,0.365204889,0.012870648,71,-0.009601321,61,1.163934426,42
EWS,20170104,145,0.245901639,0.005357509,92,-0.005088911,53,1.735849057,42
AVY,20170104,145,0.329769033,0.007667489,82,-0.005322831,63,1.301587302,42
COUP,20170322,92,0.312071918,0.020448688,53,-0.019825898,39,1.358974359,42
BYD,20170124,132,0.3221303,0.012012166,75,-0.010609835,57,1.315789474,42
HUN,20170109,142,0.33732431,0.015327844,79,-0.014199382,63,1.253968254,42
AMZN,20170104,145,0.310146159,0.008491259,84,-0.007127934,61,1.37704918,42
DUG,20170104,145,0.306195175,0.014767671,84,-0.015516084,61,1.37704918,42
KMG,20170228,108,0.357162347,0.01938831,59,-0.016280353,49,1.204081633,42
SFM,20170308,102,0.336925695,0.014770434,57,-0.011727755,45,1.266666667,42
B,20170124,132,0.313413304,0.010582229,76,-0.00930334,56,1.357142857,42
NJR,20170111,140,0.245255474,0.007468645,89,-0.008594156,51,1.745098039,42
NEE,20170110,141,0.246641318,0.005776949,89,-0.005577467,52,1.711538462,42
VVI,20170518,52,0.256709452,0.010557282,33,-0.006067469,19,1.736842105,42
TV,20170113,138,0.32998997,0.011993725,78,-0.010529228,60,1.3,42
AME,20170106,143,0.309475397,0.007334681,83,-0.005550988,60,1.383333333,42
FEP,20170104,145,0.246416382,0.005507966,92,-0.005331237,53,1.735849057,42
NTES,20170104,145,0.385084342,0.016885915,76,-0.013386816,69,1.101449275,42
CHIX,20170104,145,0.311248074,0.007594391,84,-0.005922823,61,1.37704918,42
CTRE,20170313,99,0.234858681,0.008675053,64,-0.009626822,35,1.828571429,42
DPZ,20170104,145,0.251768123,0.009876432,91,-0.012124553,54,1.685185185,42
WNS,20170110,141,0.287253809,0.008616551,84,-0.008098864,57,1.473684211,42
RUSHA,20170106,143,0.344537815,0.014138573,79,-0.012490275,64,1.234375,42
MCFT,20170118,136,0.315713251,0.012166192,78,-0.011335213,58,1.344827586,42
GTT,20170324,90,0.331182796,0.015599813,50,-0.011931978,40,1.25,41
ALR,20170201,126,0.343513514,0.009462219,69,-0.005879922,57,1.210526316,41
ZTO,20170313,99,0.284060552,0.017601575,59,-0.019052317,40,1.475,41
EPAY,20170417,75,0.263569457,0.010887978,46,-0.008956138,29,1.586206897,41
PARR,20170111,140,0.309090909,0.010759952,80,-0.009648103,60,1.333333333,41
TFX,20170104,145,0.365227244,0.009619863,77,-0.006171565,68,1.132352941,41
MKTX,20170104,145,0.36549474,0.011875588,77,-0.008585985,68,1.132352941,41
FDN,20170104,145,0.217477411,0.005276894,95,-0.006003244,50,1.9,41
HAS,20170104,145,0.302506266,0.009343957,84,-0.00816041,61,1.37704918,41
IHG,20170109,142,0.255338078,0.006512285,88,-0.006303495,54,1.62962963,41
COL,20170120,134,0.32765385,0.009478468,75,-0.007049524,59,1.271186441,41
CNA,20170113,138,0.311614026,0.008806084,79,-0.007039334,59,1.338983051,41
VC,20170104,145,0.342970101,0.012157298,79,-0.009827317,66,1.196969697,41
REGN,20170127,129,0.370829054,0.016515427,68,-0.012851742,61,1.114754098,41
MTZ,20170110,141,0.326086957,0.017957689,79,-0.017641637,62,1.274193548,41
CRSP,20170601,44,0.314977974,0.022181711,26,-0.015985712,18,1.444444444,41
BZH,20170323,91,0.342681858,0.019399162,50,-0.015743734,41,1.219512195,41
IGM,20170104,145,0.210889263,0.004602182,96,-0.005046561,49,1.959183673,41
HIFR,20170209,120,0.327428222,0.010752185,67,-0.007986493,53,1.264150943,41
EQIX,20170104,145,0.252361974,0.007285074,90,-0.007700892,55,1.636363636,41
PGR,20170104,145,0.339994371,0.007407812,80,-0.00454177,65,1.230769231,41
TROW,20170203,124,0.243792325,0.008392949,78,-0.009282308,46,1.695652174,41
NTLA,20170531,45,0.391036907,0.036650851,24,-0.024405455,21,1.142857143,41
BIB,20170125,131,0.330174927,0.016678525,73,-0.015588661,58,1.25862069,41
WEB,20170419,73,0.274566474,0.018096124,44,-0.018053686,29,1.517241379,41
SP,20170209,120,0.260948905,0.012526032,74,-0.014603841,46,1.608695652,41
JPNL,20170104,144,0.37593985,0.01383443,75,-0.01014391,69,1.086956522,40
IIVI,20170504,62,0.296663661,0.021846012,36,-0.019402937,26,1.384615385,40
GGAL,20170105,144,0.314735336,0.014955734,81,-0.014481978,63,1.285714286,40
ICUI,20170109,142,0.32056872,0.009943075,79,-0.007909361,63,1.253968254,40
ROP,20170104,145,0.278267453,0.006294084,86,-0.004934458,59,1.457627119,40
ROBO,20170104,145,0.244912039,0.005403439,90,-0.004799781,55,1.636363636,40
GIL,20170208,121,0.263246426,0.008957473,73,-0.008592458,48,1.520833333,40
CWCO,20170203,124,0.263681592,0.012206595,75,-0.013521661,49,1.530612245,40
MSB,20170104,145,0.341013825,0.022661487,79,-0.021514842,66,1.196969697,40
WLH,20170123,133,0.349339736,0.01349938,71,-0.010344305,62,1.14516129,40
RAIL,20170405,82,0.365196078,0.021626166,43,-0.014875288,39,1.102564103,40
EWP,20170104,145,0.283054004,0.007624572,85,-0.006525128,60,1.416666667,40
TRK,20170531,45,0.269344359,0.017139011,28,-0.013456792,17,1.647058824,40
BANC,20170124,132,0.38225256,0.01918372,68,-0.014558823,64,1.0625,40
CAFD,20170410,79,0.211279461,0.009388167,52,-0.010760255,27,1.925925926,40
FAF,20170117,137,0.323920717,0.008437694,76,-0.005792573,61,1.245901639,40
CMCO,20170518,52,0.362367865,0.026239461,28,-0.016092005,24,1.166666667,40
SUN,20170310,100,0.327623126,0.012467106,55,-0.008391905,45,1.222222222,40
QTWO,20170104,145,0.320490368,0.012877506,81,-0.011647789,64,1.265625,40
GMF,20170104,145,0.279963041,0.005649575,86,-0.004000052,59,1.457627119,40
FBT,20170104,145,0.256841877,0.009577104,89,-0.010920568,56,1.589285714,40
TMF,20170314,98,0.278601067,0.013923025,58,-0.013663465,40,1.45,40
SEM,20170323,91,0.29218107,0.013318297,53,-0.011492936,38,1.394736842,40
EWW,20170120,134,0.350503115,0.010610139,72,-0.00732767,62,1.161290323,40
LAUR,20170306,104,0.3648,0.016806664,55,-0.012105048,49,1.12244898,40
SYMC,20170104,145,0.260724698,0.009096911,88,-0.0097728,57,1.543859649,40
NCLH,20170104,145,0.314559477,0.011754864,82,-0.010684787,63,1.301587302,40
BRKR,20170104,145,0.319277108,0.011559005,80,-0.009732348,65,1.230769231,39
JO,20170623,28,0.230019493,0.015101448,20,-0.011269294,8,2.5,39
CCS,20170120,134,0.243373494,0.011123422,83,-0.013504675,51,1.62745098,39
OEC,20170602,43,0.16954023,0.012462623,31,-0.018355973,12,2.583333333,39
LMNR,20170124,132,0.327327327,0.016087669,72,-0.014120682,60,1.2,39
ARR,20170201,126,0.219790676,0.007756087,81,-0.009347227,45,1.8,39
V,20170104,145,0.265283019,0.006121075,87,-0.005047117,58,1.5,39
VRTU,20170104,145,0.299641862,0.016719409,82,-0.016808775,63,1.301587302,39
CHDN,20170131,127,0.341687257,0.009775396,68,-0.006146189,59,1.152542373,39
LHCG,20170113,138,0.344758065,0.012640571,74,-0.009608335,64,1.15625,39
TRMB,20170131,127,0.289706885,0.009126184,73,-0.007419749,54,1.351851852,39
ENTA,20170227,109,0.4004329,0.020036831,54,-0.013018865,55,0.981818182,39
BCC,20170120,134,0.30349345,0.015438814,76,-0.015174524,58,1.310344828,39
BBL,20170621,30,0.230476849,0.012880341,21,-0.006656977,9,2.333333333,39
VEDL,20170105,144,0.386363636,0.018963948,73,-0.014437572,71,1.028169014,39
ANTM,20170110,141,0.340710134,0.009224291,76,-0.0061447,65,1.169230769,39
TITN,20170327,89,0.296827795,0.016983789,51,-0.015322252,38,1.342105263,39
AJRD,20170110,141,0.339707537,0.013132339,76,-0.010579584,65,1.169230769,39
FTEC,20170104,145,0.202637244,0.004603003,96,-0.005186696,49,1.959183673,39
AXDX,20170131,127,0.345177665,0.020711767,68,-0.018091593,59,1.152542373,39
NNI,20170526,47,0.217857143,0.011309133,31,-0.009331225,16,1.9375,39
ORCL,20170109,142,0.306371912,0.007206655,80,-0.00485112,62,1.290322581,39
BHP,20170622,29,0.211761212,0.012026439,21,-0.007212009,8,2.625,39
PTHN,20170424,70,0.398318655,0.013998007,35,-0.003086742,35,1,39
LIT,20170104,145,0.287615974,0.007493099,84,-0.006071397,61,1.37704918,39
FIVE,20170314,98,0.312134114,0.014722779,54,-0.011492433,44,1.227272727,38
ARNC,20170104,145,0.319697759,0.015408642,79,-0.013803566,66,1.196969697,38
AMCX,20170518,52,0.250096637,0.013803394,32,-0.010560308,20,1.6,38
VTTI,20170104,145,0.162162162,0.003952722,102,-0.005773671,43,2.372093023,38
TTC,20170104,145,0.274955595,0.007215474,85,-0.006082057,60,1.416666667,38
ETQ,20170130,90,0.202145215,0.006638115,59,-0.006564374,31,1.903225806,38
AAL,20170323,91,0.252540273,0.013439176,55,-0.013877155,36,1.527777778,38
BWA,20170407,80,0.207686233,0.011338016,52,-0.013907602,28,1.857142857,38
CHU,20170123,133,0.277876106,0.01166207,77,-0.011345982,56,1.375,38
A,20170104,145,0.29855883,0.008551925,82,-0.00685466,63,1.301587302,38
FDC,20170417,75,0.232950709,0.010678466,47,-0.010218367,28,1.678571429,38
PRSC,20170124,132,0.348456376,0.012229701,69,-0.008364657,63,1.095238095,38
USD,20170118,136,0.295816146,0.015277522,77,-0.01506524,59,1.305084746,38
TREX,20170530,46,0.239757692,0.012229403,29,-0.007947268,17,1.705882353,38
JAZZ,20170104,145,0.385340032,0.014587333,72,-0.009570578,73,0.98630137,38
PKG,20170104,145,0.295516064,0.009218801,82,-0.007725018,63,1.301587302,38
FCX,20170622,29,0.281891169,0.020230894,19,-0.012174475,10,1.9,38
ITRI,20170309,101,0.233390119,0.010259984,63,-0.011220695,38,1.657894737,38
AFH,20170425,69,0.22,0.01390291,44,-0.015709588,25,1.76,38
EW,20170215,116,0.301262711,0.010180154,65,-0.007562878,51,1.274509804,38
GPX,20170313,99,0.256521739,0.014119985,59,-0.014703729,40,1.475,37
DLS,20170104,145,0.19768595,0.004000145,95,-0.00395427,50,1.9,37
IYW,20170104,145,0.200825423,0.004819936,94,-0.005226903,51,1.843137255,37
HBI,20170206,123,0.256059009,0.011834822,73,-0.012412484,50,1.46,37
VGT,20170104,145,0.202270129,0.004703755,94,-0.004994804,51,1.843137255,37
UPRO,20170104,145,0.32011976,0.009939399,78,-0.00725966,67,1.164179104,37
CONE,20170104,145,0.257074962,0.009342724,86,-0.009552029,59,1.457627119,37
QQQ,20170104,145,0.199815915,0.004349355,95,-0.004566061,50,1.9,37
PMC,20170317,95,0.307692308,0.01578142,52,-0.012292245,43,1.209302326,37
PLD,20170202,125,0.261767135,0.008432107,74,-0.007554408,51,1.450980392,37
AVD,20170322,92,0.315614618,0.018499656,50,-0.014770337,42,1.19047619,37
BOFI,20170607,40,0.255591054,0.01613726,25,-0.011210475,15,1.666666667,37
NUS,20170224,110,0.298602287,0.010916769,61,-0.008057528,49,1.244897959,37
IMOS,20170105,144,0.296119809,0.012067249,80,-0.010744665,64,1.25,37
ENV,20170328,88,0.225755167,0.009889953,55,-0.010080906,33,1.666666667,37
EPAM,20170104,145,0.286522149,0.009780418,82,-0.008565104,63,1.301587302,37
KSU,20170104,145,0.262682504,0.009303906,85,-0.009102265,60,1.416666667,37
XBI,20170104,145,0.289310287,0.011685918,82,-0.010919358,63,1.301587302,37
BKFS,20170120,134,0.229317852,0.00878126,83,-0.010039016,51,1.62745098,37
DQ,20170424,70,0.380666303,0.029411258,35,-0.01912679,35,1,37
PM,20170117,137,0.266482301,0.00740025,80,-0.006141949,57,1.403508772,37
CAF,20170117,137,0.259792627,0.008058414,80,-0.007085807,57,1.403508772,36
BAK,20170519,51,0.291732491,0.019515427,29,-0.013586511,22,1.318181818,36
KE,20170323,91,0.239202658,0.01272019,55,-0.013076759,36,1.527777778,36
ZEN,20170104,145,0.274288296,0.015246521,83,-0.015831304,62,1.338709677,36
BSFT,20170502,64,0.240056818,0.010316643,39,-0.007309558,25,1.56,36
MDC,20170110,141,0.330119553,0.012875498,74,-0.009649527,67,1.104477612,36
WMT,20170130,128,0.231647883,0.006843339,78,-0.00638954,50,1.56,36
TGI,20170515,55,0.386363636,0.039183751,27,-0.022907798,28,0.964285714,36
PLNT,20170420,72,0.259796028,0.012472982,42,-0.009508671,30,1.4,36
TWLO,20170510,58,0.245144584,0.01732556,35,-0.016268936,23,1.52173913,36
LULU,20170531,45,0.262784387,0.014793196,27,-0.008635507,18,1.5,36
CLLS,20170123,133,0.319063927,0.020653177,71,-0.018426963,62,1.14516129,36
TSS,20170202,125,0.266295707,0.007547526,72,-0.005669474,53,1.358490566,36
SERV,20170519,51,0.229080933,0.011847617,32,-0.008652644,19,1.684210526,36
EFX,20170202,125,0.236583909,0.006686338,76,-0.0059311,49,1.551020408,36
SAIA,20170417,75,0.276442308,0.016643877,43,-0.014270152,32,1.34375,36
CBM,20170315,97,0.242211055,0.011754181,58,-0.011612773,39,1.487179487,36
ANIK,20170324,90,0.252876318,0.012130843,53,-0.010893449,37,1.432432432,36
LBTYA,20170616,33,0.201812478,0.011600912,23,-0.008006035,10,2.3,36
CEQP,20170622,29,0.26119403,0.018933483,19,-0.012061186,10,1.9,35
MSG,20170124,132,0.294668975,0.009543298,72,-0.007011559,60,1.2,35
RXL,20170125,130,0.325396825,0.011085206,68,-0.007473936,62,1.096774194,35
BKF,20170104,145,0.26006192,0.007142873,84,-0.005959994,61,1.37704918,35
WBC,20170118,136,0.318491508,0.010187788,72,-0.007002678,64,1.125,35
LMT,20170202,125,0.178995616,0.004913494,83,-0.005721907,42,1.976190476,35
BID,20170109,142,0.321022727,0.014291093,75,-0.011386126,67,1.119402985,35
QSR,20170104,145,0.291276596,0.009799639,80,-0.007950551,65,1.230769231,35
EVTC,20170504,62,0.225589226,0.013424275,38,-0.012332729,24,1.583333333,35
SGC,20170203,124,0.290572792,0.017840116,68,-0.016502439,56,1.214285714,35
MA,20170202,125,0.237047619,0.00640545,75,-0.005276904,50,1.5,35
ALG,20170417,75,0.262669621,0.01087999,43,-0.007146284,32,1.34375,35
PTH,20170104,145,0.279840571,0.009521864,81,-0.008047084,64,1.265625,35
QQQC,20170104,141,0.243966165,0.008541292,84,-0.00861028,57,1.473684211,35
HEI,20170421,71,0.205694364,0.009607504,45,-0.009233762,26,1.730769231,35
BATRA,20170209,120,0.289623129,0.014455903,66,-0.012560504,54,1.222222222,35
ORBK,20170307,103,0.268335071,0.011809267,59,-0.010144033,44,1.340909091,35
HCSG,20170104,145,0.333505955,0.010399138,75,-0.006811063,70,1.071428571,35
STZ,20170106,143,0.315434412,0.009335825,76,-0.006347198,67,1.134328358,35
PIE,20170104,145,0.234817814,0.006457936,87,-0.005972569,58,1.5,35
SCHE,20170104,145,0.211954023,0.00585561,90,-0.006012369,55,1.636363636,34
CLGX,20170130,128,0.295915453,0.009063299,69,-0.006094391,59,1.169491525,34
ECH,20170110,141,0.224341752,0.007070054,85,-0.007015323,56,1.517857143,34
CHKP,20170104,145,0.254463758,0.008439258,83,-0.00745169,62,1.338709677,34
MAR,20170106,143,0.267702091,0.007962849,81,-0.006443187,62,1.306451613,34
ARGT,20170104,145,0.247043919,0.008338034,84,-0.00773783,61,1.37704918,34
AMP,20170118,136,0.311071268,0.011312651,72,-0.008309614,64,1.125,34
AMBC,20170621,30,0.232807571,0.020879522,20,-0.018836499,10,2,34
EEM,20170104,145,0.235958227,0.00635167,86,-0.005594885,59,1.457627119,34
MTRN,20170327,89,0.205974843,0.01022295,56,-0.011341897,33,1.696969697,34
GPN,20170104,145,0.34964539,0.010919003,72,-0.006502322,73,0.98630137,34
MNTA,20170424,70,0.232824427,0.018436759,42,-0.019469041,28,1.5,34
MYE,20170309,101,0.299625468,0.019426648,54,-0.016170268,47,1.14893617,34
ALLY,20170518,52,0.243139407,0.012559968,31,-0.007903867,21,1.476190476,34
LMOS,20170216,115,0.19320453,0.003397191,74,-0.001538727,41,1.804878049,34
HUM,20170208,121,0.274533907,0.009015685,67,-0.006560702,54,1.240740741,34
DHI,20170104,145,0.318214804,0.011289128,75,-0.007979508,70,1.071428571,34
CRM,20170104,145,0.28083357,0.007870644,80,-0.005773539,65,1.230769231,34
LKQ,20170417,75,0.220830351,0.009021904,46,-0.007264744,29,1.586206897,34
PKI,20170125,131,0.286600737,0.008248366,72,-0.005668952,59,1.220338983,34
SAP,20170104,145,0.241830823,0.006844251,85,-0.005991975,60,1.416666667,34
LH,20170104,145,0.243976137,0.007388385,85,-0.006699282,60,1.416666667,34
AMOT,20170315,97,0.32450675,0.020457852,50,-0.015076345,47,1.063829787,34
MFC,20170518,52,0.226754649,0.011017897,32,-0.007210756,20,1.6,34
AGCO,20170417,75,0.244184043,0.009534359,44,-0.006329077,31,1.419354839,34
ENSG,20170214,117,0.247262248,0.011878984,68,-0.011662619,49,1.387755102,34
IEMG,20170104,145,0.230482405,0.006072425,87,-0.005463506,58,1.5,34
EGP,20170203,124,0.24804744,0.008012942,72,-0.006728835,52,1.384615385,34
KMPR,20170518,52,0.283378747,0.018918115,29,-0.012391539,23,1.260869565,34
OAK,20170104,145,0.231469441,0.007255444,87,-0.007174477,58,1.5,34
EWY,20170104,145,0.27114566,0.008314135,80,-0.006438704,65,1.230769231,33
PUK,20170119,135,0.272490222,0.009453089,74,-0.007386498,61,1.213114754,33
VAR,20170201,126,0.250998068,0.007688979,72,-0.006004474,54,1.333333333,33
EBS,20170406,81,0.244522968,0.013079357,47,-0.011307123,34,1.382352941,33
EE,20170131,127,0.192650334,0.006267966,81,-0.007108977,46,1.760869565,33
LM,20170104,145,0.24723127,0.011349834,83,-0.01136782,62,1.338709677,33
AMPH,20170315,97,0.28852459,0.01619683,52,-0.012571133,45,1.155555556,33
ELY,20170207,122,0.234653465,0.009401653,72,-0.00912899,50,1.44,33
CAMP,20170104,145,0.307162534,0.012499863,76,-0.009570282,69,1.101449275,33
MRLN,20170124,132,0.251219512,0.014498669,75,-0.014729641,57,1.315789474,33
MTH,20170210,119,0.288888889,0.01224065,64,-0.009386275,55,1.163636364,33
GWPH,20170609,38,0.178563841,0.015456861,26,-0.018995838,12,2.166666667,33
SBIO,20170131,127,0.24197861,0.011120374,74,-0.011175594,53,1.396226415,33
RTN,20170127,129,0.218614416,0.005939692,78,-0.005142252,51,1.529411765,33
PJT,20170118,136,0.319512998,0.014594849,70,-0.010947175,66,1.060606061,33
FN,20170505,61,0.330959752,0.025406086,31,-0.01565272,30,1.033333333,33
MTGE,20170310,100,0.207006369,0.008123243,62,-0.008154677,38,1.631578947,33
NWS,20170104,145,0.215767635,0.008857334,88,-0.010042331,57,1.543859649,33
EWT,20170104,145,0.241089442,0.006403443,84,-0.005209643,61,1.37704918,33
DGS,20170104,145,0.212382644,0.005469187,89,-0.005191821,56,1.589285714,33
PFPT,20170421,71,0.217464789,0.016907953,43,-0.018199213,28,1.535714286,33
XYL,20170209,120,0.267234043,0.009680168,67,-0.007622946,53,1.264150943,33
PEK,20170511,57,0.18,0.007218755,37,-0.00498616,20,1.85,32
GLPG,20170131,127,0.197480952,0.011601486,79,-0.014960802,48,1.645833333,32
GRFS,20170104,145,0.299378882,0.010718939,76,-0.007850013,69,1.101449275,32
LPX,20170123,133,0.2952735,0.013333203,70,-0.010418211,63,1.111111111,32
INVA,20170131,127,0.237775647,0.015009973,73,-0.015804999,54,1.351851852,32
SWK,20170104,145,0.229114471,0.006665881,85,-0.005920002,60,1.416666667,32
AGO,20170328,88,0.234469489,0.009948772,51,-0.007858098,37,1.378378378,32
CBG,20170124,132,0.246338216,0.010830214,75,-0.010149324,57,1.315789474,32
QBQ,20170123,95,0.165394609,0.00480972,63,-0.004621342,32,1.96875,32
GDDY,20170113,138,0.247893054,0.009972115,78,-0.009085258,60,1.3,32
PEN,20170104,145,0.25058548,0.01619757,82,-0.016985137,63,1.301587302,32
EL,20170104,145,0.269494375,0.007344501,79,-0.00508924,66,1.196969697,32
GEM,20170104,145,0.223620881,0.006058647,86,-0.005345471,59,1.457627119,32
DFE,20170104,145,0.234639927,0.005783443,84,-0.004452605,61,1.37704918,32
MUSA,20170109,142,0.203342618,0.010865656,87,-0.013470096,55,1.581818182,32
TRS,20170417,75,0.208542714,0.011519707,46,-0.011326533,29,1.586206897,32
SR,20170208,121,0.196485623,0.006465281,75,-0.006552997,46,1.630434783,32
CTLT,20170118,136,0.324574961,0.013453543,68,-0.009076349,68,1,32
RDUS,20170518,52,0.310218978,0.028338312,27,-0.018687797,25,1.08,32
VICR,20170213,118,0.247349823,0.016108391,67,-0.016287628,51,1.31372549,32
DMRC,20170315,97,0.269776876,0.024558912,53,-0.02276095,44,1.204545455,32
SPXC,20170417,75,0.26981982,0.017399553,41,-0.013207567,34,1.205882353,32
SCZ,20170104,145,0.198324022,0.004180434,90,-0.00351533,55,1.636363636,32
EWQ,20170104,145,0.207623682,0.005928135,87,-0.005543806,58,1.5,31
MTUM,20170104,145,0.211750789,0.003969952,87,-0.00261513,58,1.5,31
FBHS,20170104,145,0.20690295,0.006542317,87,-0.006479372,58,1.5,31
GILD,20170619,32,0.159856519,0.009743833,23,-0.008130112,9,2.555555556,31
WERN,20170417,75,0.211498973,0.013009873,45,-0.012681321,30,1.5,31
GOL,20170524,49,0.349234923,0.030821414,24,-0.01655089,25,0.96,31
IEX,20170203,124,0.29516454,0.009514742,64,-0.00570904,60,1.066666667,31
BATRK,20170209,120,0.292030848,0.014311245,62,-0.010563257,58,1.068965517,31
VIV,20170519,51,0.138473054,0.008682014,36,-0.01187507,15,2.4,31
PSB,20170314,98,0.207805143,0.007019143,59,-0.005697921,39,1.512820513,31
AA,20170104,145,0.286507111,0.019222764,76,-0.016848491,69,1.101449275,31
SWFT,20170328,88,0.300306435,0.018799207,45,-0.012677941,43,1.046511628,31
CSII,20170110,141,0.290391611,0.016559119,73,-0.013618294,68,1.073529412,31
SHOO,20170131,127,0.224035608,0.010307579,74,-0.010370641,53,1.396226415,31
THG,20170518,52,0.207097655,0.00941541,32,-0.005524377,20,1.6,31
LCII,20170531,45,0.188711517,0.011913878,29,-0.010490115,16,1.8125,31
BAP,20170428,66,0.24670966,0.010218037,37,-0.005312983,29,1.275862069,31
WLTW,20170210,119,0.201566835,0.006640154,73,-0.006425907,46,1.586956522,31
SIG,20170531,45,0.251670844,0.021672003,26,-0.017029804,19,1.368421053,31
PICO,20170310,100,0.256603774,0.014060387,55,-0.011788951,45,1.222222222,31
BPT,20170310,100,0.25477707,0.020027204,55,-0.018566149,45,1.222222222,31
VOD,20170207,122,0.219082719,0.006908886,72,-0.005881688,50,1.44,31
KLXI,20170328,88,0.196403873,0.011638446,54,-0.01291365,34,1.588235294,31
AB,20170505,61,0.17961165,0.008556289,39,-0.007505789,22,1.772727273,31
QRVO,20170104,145,0.264461248,0.012936961,79,-0.011614044,66,1.196969697,31
RES,20170328,88,0.250742721,0.021341821,49,-0.020303309,39,1.256410256,31
RUSL,20170622,29,0.316666667,0.029557617,17,-0.017751953,12,1.416666667,31
MPWR,20170106,143,0.225712905,0.010775312,83,-0.011278706,60,1.383333333,31
EFG,20170104,145,0.192976956,0.004195914,90,-0.003620498,55,1.636363636,31
AEIS,20170104,145,0.250547445,0.013250418,81,-0.012908281,64,1.265625,31
CPK,20170124,132,0.244479495,0.008800163,74,-0.007318781,58,1.275862069,31
SGRY,20170104,145,0.251612903,0.01807108,81,-0.018483923,64,1.265625,31
EDIT,20170601,44,0.262079063,0.029108807,25,-0.024646314,19,1.315789474,31
QVCA,20170208,121,0.265163714,0.012360931,66,-0.010239941,55,1.2,31
UNH,20170221,113,0.23569344,0.007069443,65,-0.00509028,48,1.354166667,31
MGM,20170310,100,0.241053873,0.012562573,57,-0.011358489,43,1.325581395,31
CAJ,20170104,145,0.236453202,0.006412182,83,-0.005079985,62,1.338709677,31
ITUB,20170519,51,0.215264188,0.013141009,31,-0.010277531,20,1.55,31
PRTA,20170131,127,0.270002157,0.022440534,68,-0.020970807,59,1.152542373,31
EWD,20170111,140,0.1927627,0.00616228,87,-0.006691074,53,1.641509434,31
SLF,20170607,40,0.173259736,0.008938657,27,-0.006090435,13,2.076923077,31
LOGM,20170301,107,0.235422343,0.013742885,61,-0.013213455,46,1.326086957,31
PNM,20170120,134,0.224215247,0.007398457,78,-0.006589827,56,1.392857143,31
LPLA,20170104,145,0.273237855,0.01294242,78,-0.011154602,67,1.164179104,31
IBKR,20170420,72,0.201003542,0.007990006,44,-0.005901364,28,1.571428571,31
HAO,20170104,145,0.214309343,0.006216141,86,-0.005699531,59,1.457627119,31
XEL,20170111,140,0.194092827,0.005506951,87,-0.00562847,53,1.641509434,31
SUM,20170322,92,0.263954998,0.014514928,50,-0.011400993,42,1.19047619,31
ECON,20170104,145,0.220982143,0.007215404,84,-0.006570997,61,1.37704918,30
CTMX,20170104,145,0.232492997,0.023393587,82,-0.025565293,63,1.301587302,30
DO,20170710,19,0.229941292,0.024439341,14,-0.025539257,5,2.8,30
IHI,20170104,145,0.221257485,0.0054213,84,-0.004141591,61,1.37704918,30
AFTY,20170104,131,0.233125653,0.00706739,74,-0.005420845,57,1.298245614,30
COH,20170110,141,0.318948271,0.012406734,69,-0.007811103,72,0.958333333,30
TX,20170208,121,0.316540348,0.017875158,59,-0.012175289,62,0.951612903,30
TRNO,20170208,121,0.30693816,0.009572025,60,-0.004922047,61,0.983606557,30
ELS,20170104,145,0.230833917,0.006976869,83,-0.005907388,62,1.338709677,30
COWN,20170322,92,0.23715415,0.019253958,52,-0.018763567,40,1.3,30
OPB,20170323,91,0.274193548,0.014612299,48,-0.010360875,43,1.11627907,30
DVMT,20170104,145,0.172988822,0.007193058,92,-0.009289417,53,1.735849057,30
DDM,20170120,134,0.252675887,0.007136872,73,-0.004769535,61,1.196721311,30
AMAG,20170616,33,0.170807453,0.013783193,23,-0.015381498,10,2.3,30
IART,20170410,79,0.197014195,0.010883214,48,-0.010675164,31,1.548387097,30
XL,20170110,141,0.205114255,0.007263672,84,-0.007295754,57,1.473684211,30
TSEM,20170104,145,0.272964509,0.013587081,76,-0.011133294,69,1.101449275,30
TIF,20170106,143,0.208826976,0.009561662,85,-0.010494292,58,1.465517241,30
MNST,20170301,107,0.282335907,0.011219817,56,-0.007178252,51,1.098039216,30
ABT,20170104,145,0.258898848,0.007492654,78,-0.005208207,67,1.164179104,30
AMG,20170120,134,0.274798359,0.01049165,70,-0.007497823,64,1.09375,30
TOL,20170118,136,0.276375405,0.010787757,71,-0.007857997,65,1.092307692,30
EQT,20170622,29,0.222112925,0.017808497,19,-0.013021597,10,1.9,30
SFR,20170110,141,0.189661195,0.006337749,87,-0.006897728,54,1.611111111,30
IPAY,20170104,145,0.200694712,0.005076598,87,-0.004409218,58,1.5,30
TMO,20170125,131,0.246559796,0.007270656,72,-0.005021833,59,1.220338983,30
TU,20170309,101,0.159757653,0.005424701,66,-0.005909743,35,1.885714286,30
EZJ,20170104,107,0.248211857,0.010809585,59,-0.008479013,48,1.229166667,30
DE,20170104,145,0.244690053,0.007798327,80,-0.006107523,65,1.230769231,30
EZU,20170104,148,0.212802768,0.005706122,87,-0.004897342,61,1.426229508,30
QTEC,20170104,145,0.205427818,0.006220207,87,-0.006024342,58,1.5,30
MHK,20170113,138,0.244076534,0.00719621,77,-0.005411948,61,1.262295082,30
SCCO,20170104,145,0.218035825,0.010884419,85,-0.01187376,60,1.416666667,30
ALLE,20170111,140,0.252093023,0.00836988,77,-0.006534426,63,1.222222222,30
